type octile
height 12
width 20
map
TTTTTTTTTTTTTTTTTTTT
T..................T
T..................T
TTTTTTTTT.TTTTTTTTTT
TTTTTTTTT.TTTTTTTTTT
T..................T
T..................T
T..................T
T..................T
T..................T
T..................T
TTTTTTTTTTTTTTTTTTTT
