type octile
height 49
width 100
map
TTTTTTTTTTTTTTTTTTTTTTTTTTTTTTTTTTTTTTTTTTTTTTTTTTTTTTTTTTTTTTTTTTTTTTTTTTTTTTTTTTTTTTTTTTTTTTTTTTTT
TTT...............................................................................................TT
TT................................................................................................TT
T..................................................................................................T
T..................................................................................................T
T..................................................................................................T
T..................................................................................................T
T..................................................................................................T
T..................................................................................................T
T..................................................................................................T
T..................................................................................................T
T..................................................................................................T
T..................................................................................................T
T..................................................................................................T
T..................................................................................................T
TTT...............................................................................................TT
TTT...............................................................................................TT
TTT...............................................................................................TT
TT................................................................................................TT
TT.................................................................................................T
TT.................................................................................................T
TT.................................................................................................T
TT.................................................................................................T
T..................................................................................................T
T..................................................................................................T
T..................................................................................................T
TT.................................................................................................T
TTT................................................................................................T
TTT................................................................................................T
TTT................................................................................................T
T..................................................................................................T
TTT...............................................................................................TT
TTT...............................................................................................TT
TTT...............................................................................................TT
TT................................................................................................TT
T..................................................................................................T
T..................................................................................................T
T..................................................................................................T
T..................................................................................................T
T..................................................................................................T
T..................................................................................................T
T..................................................................................................T
T..................................................................................................T
T..................................................................................................T
T..................................................................................................T
T..................................................................................................T
T..................................................................................................T
TTT...............................................................................................TT
TTTTTTTTTTTTTTTTTTTTTTTTTTTTTTTTTTTTTTTTTTTTTTTTTTTTTTTTTTTTTTTTTTTTTTTTTTTTTTTTTTTTTTTTTTTTTTTTTTTT
