type octile
height 77
width 93
map
@@@@@@@@@@@@@@@@@@@@TTTTTTTT..TTTTTTT@@@@@@@@@@@@@@@@@@@@@@@@@@@@@@@@@@@@@@@@@@@@@@@@@@@@@@@@
@@@@@@@@@@@@@@@@@@@@TTTTTTTT..TTTTTTT@@@@@@@@@@@@@@@@@@@@@@@@@@@@@@@@@@@@@@@@@@@@@@@@@@@@@@@@
@@@@@@@@@@@@@@@@@@@@TTTTT.....TTT..TT@@@@@@@@@@@@@@@@@@@@@@@@@@@@@@@@@@@@@@@@@@@@@@@@@@@@@@@@
@@@@@@@@@@@@@@@@@@@@TTT............TT@@@@@@@@@@@@@@@@@@@@@@@@@@@@@@@@@@@@@@@@@@@@@@@@@@@@@@@@
@@@@@@@@@@@@@@@@@@@@TTTT...........TT@@@@@@@@@@@@@@@@@@@@@@@@@@@@@@@@@@@@@@@@@@@@@@@@@@@@@@@@
@@@@@@@@@@@@@@@@@@@@TTTT...........TT@@@@@@@@@@@@@@@@@@@@@@@@@@@@@@@@@@@@@@@@@@@@@@@@@@@@@@@@
@@@@@@@@@@@@@@@@@@@@TTTT............T@@@@@@@@@@@@@@@@@@@@@@@@@@@@@@@@@@@@@@@@@@@@@@@@@@@@@@@@
@@@@@@@@@@@@@@@@@@@@TT.............TT@@@@@@@@@@@@@@@@@@@@@@@@@@@@@@@@@@@@@@@@@@@@@@@@@@@@@@@@
@@@@@@@@@@@@@@@@@@@@TT............TTT@@@@@@@@@@@@@@@@@@@TTTTTTTTTTTTTTTTTTTTTTTTTTTTTTTTT@@@@
@@@@@@@@@@@@@@@@@@@@TTTT..........TTT@@@@@@@@@@@@@@@@@@@TTTTTTTTTTTTTTTTTTTTTTTTTTTTTTTTT@@@@
@@@@@@@@@@@@@@@@@@@@TTTTT.........TTT@@@@@@@@@@@@@@@@@@@TTTTT...........................T@@@@
@@@@@@@@@@@@@@@@@@@@TTTTT.........TTT@@@@@@@@@@@@@@@@@@@TTTT............................T@@@@
@@@@@@@@@@@@@@@@@@@@TTTTT........TTTT@@@@@@@@@@@@@@@@@@@TT...............................@@@@
@@@@@@@@@@@@@@@@@@@@TTTTT........TTTT@@@@@@@@@@@@@@@@@@@TT...............................@@@@
@@@@@@@@@@@@@@@@@@@@TTTTTT.......TTTT@@@@@@@@@@@@@@@@@@@TT..............................T@@@@
@@@@@@@@@@@@@@@@@@@@TTTTTTTTT.TTTTTTT@@@@@@@@@@@@@@@@@@@TT.....TTTTT..TTT...............T@@@@
TTTTTTTTTTTTTTTTTTTTTTTTTTTTT.TTTTTTTTTTTTTTTTTTTTTTTTTTTT.....TTTTT..TTTTTTTTTTTTTTTTTTT@@@@
TTTTTTTTTTTTTTTTTTTTTTTTTTTTT.TTTTTTTTTTTTTTTTTTTTTTTTTTTT.....TTTTT..TTTTTTTTTTTTTTTTTTT@@@@
TT....TT...TTT.......TTTTT.....TTT....T...T..........TTTTT......TT........TTTTTT.......TT@@@@
TT........TTTT.........TTT.....TTT........T.........TTTTTT......TT........TTTTTT.......TT@@@@
TT........TTTT.........TTT.....TTT.T......T.TTTTTT...TTTTT......TT........TTTTTT......TTT@@@@
TT........TTTT.........TTT.....TTT....................TTTT......TT.....................TT@@@@
TT........TTTT.........TTT.....TTT......................TT......TT......................T@@@@
TT......TT.....TTT.....TTT.....TTT......................TT......TT......................T@@@@
TT......TT.....TTT.....TTT.....TTT....................TTTT......TT......................TTTTT
TT.....................TTT.....TTTTT.................TTTTT......TT......................TTTTT
TT.....................TTT.....TTTTTT................TTTTT......TT.............TT.......TTTTT
.......................TTT.....TTTTTT................TTTTT......TT.........T.TTTT.......TTTTT
.......................TTT.....TTTTTT..................TTT......TT.........TTTTT........TTTTT
.......................TTT.....TTTTT....................TT......TT.........TTTTTT.......TTTTT
TT.....................TTT.....TTTTT....................TT......TT.........TTTTTT.......TTTTT
TT.......TT............TTT.....TTTTT..................TTTT......TT..........TTTT........TTTTT
TT....TTTTTT...........TTT.....TTTT..................TTTTT......TT...........TT.TTTTTTTTTTTTT
TTT...TTTTTT...........TTT.....TTTT..................TTTTT......TTT.............T@@@@@@@@@@@@
TTT....TTTTTT..........TTT.....TTTT...................T.TT......TTT.............T@@@@@@@@@@@@
TT.....TTTTTT..........TT......TTT......................TT......TT............TTT@@@@@@@@@@@@
TT.....TTTT....................TTT......................TT......TT............TTT@@@@@@@@@@@@
TT.....TTTT....................TTT..T...................TT......TTTT..........TTT@@@@@@@@@@@@
TTTT...................TTT.....TTTT.....................TT......TTTT..........TTT@@@@@@@@@@@@
TTTT...................TTT.....TTTT.....TTTT..TTT.......TT......TTTT............T@@@@@@@@@@@@
TTTT....TT....TTTT.....TTT.....TTTTTTTTTTTTT..TTTTTTTTTTTT......TTTTTTTTTTTT..TTT@@@@@@@@@@@@
TT......TT....TTTT.....TTT.....TTTTTTTTTTTTT..TTTTTTTTTTTT......T@@@@@@@@@@@@@@@@@@@@@@@@@@@@
TT..............TT.....TTT..............................TT......T@@@@@@@@@@@@@@@@@@@@@@@@@@@@
TT.....................TTT......................................T@@@@@@@@@@@@@@@@@@@@@@@@@@@@
TT.....................TTT......................................T@@@@@@@@@@@@@@@@@@@@@@@@@@@@
TT.....................TTT......................................T@@@@@@@@@@@@@@@@@@@@@@@@@@@@
TT......TTTTTTTTTT...TTTTT......................................T@@@@@@@@@@@@@@@@@@@@@@@@@@@@
TT......TTTTTTTTTT...TTTTTTTTTTTTTTT.TTTTTTTTTTTTTTTTTTTTT......T@@@@@@@@@@@@@@@@@@@@@@@@@@@@
TTTTTTTTTTTTTTTTTTTTTTTTTTTTTTTTTTTT.TTTTTTTTTTTTTTTTTTTTT......T@@@@@@@@@@@@@@@@@@@@@@@@@@@@
@@@@@@@@@@@@@@@@@@@@@@@@@@@@@@@@TTTT.TTTTTTTTTTTTTTTTTTTTT......T@@@@@@@@@@@@@@@@@@@@@@@@@@@@
@@@@@@@@@@@@@@@@@@@@@@@@@@@@@@@@TT.............TTTTTTT.TTT......T@@@@@@@@@@@@@@@@@@@@@@@@@@@@
@@@@@@@@@@@@@@@@@@@@@@@@@@@@@@@@TT.............TTTTTTT.TTT......T@@@@@@@@@@@@@@@@@@@@@@@@@@@@
@@@@@@@@@@@@@@@@@@@@@@@@@@@@@@@@TT................TTTT.TTT......T@@@@@@@@@@@@@@@@@@@@@@@@@@@@
@@@@@@@@@@@@@@@@@@@@@@@@@@@@@@@@TT................TTTT.TTT......T@@@@@@@@@@@@@@@@@@@@@@@@@@@@
@@@@@@@@@@@@@@@@@@@@@@@@@@@@@@@@TT................TTTT.TTT......T@@@@@@@@@@@@@@@@@@@@@@@@@@@@
@@@@@@@@@@@@@@@@@@@@@@@@@@@@@@@@TT.....................TTT......T@@@@@@@@@@@@@@@@@@@@@@@@@@@@
@@@@@@@@@@@@@@@@@@@@@@@@@@@@@@@@TT.....................TTT......T@@@@@@@@@@@@@@@@@@@@@@@@@@@@
@@@@@@@@@@@@@@@@@@@@@@@@@@@@@@@@TT.....................TTT......T@@@@@@@@@@@@@@@@@@@@@@@@@@@@
@@@@@@@@@@@@@@@@@@@@@@@@@@@@@@@@TT...........T.........TTT......T@@@@@@@@@@@@@@@@@@@@@@@@@@@@
@@@@@@@@@@@@@@@@@@@@@@@@@@@@@@@@TT........TTTT.........TTT......T@@@@@@@@@@@@@@@@@@@@@@@@@@@@
@@@@@@@@@@@@@@@@@@@@@@@@@@@@@@@@TT........TTTT.........TTT......T@@@@@@@@@@@@@@@@@@@@@@@@@@@@
@@@@@@@@@@@@@@@@@@@@@@@@@@@@@@@@TT.....................TTT......T@@@@@@@@@@@@@@@@@@@@@@@@@@@@
@@@@@@@@@@@@@@@@@@@@@@@@@@@@@@@@TT.....................TTT......T@@@@@@@@@@@@@@@@@@@@@@@@@@@@
@@@@@@@@@@@@@@@@@@@@@@@@@@@@@@@@TT..............T......TTT......T@@@@@@@@@@@@@@@@@@@@@@@@@@@@
@@@@@@@@@@@@@@@@@@@@@@@@@@@@@@@@TT.............TTT.....TTT......T@@@@@@@@@@@@@@@@@@@@@@@@@@@@
@@@@@@@@@@@@@@@@@@@@@@@@@@@@@@@@TT.............TT......TTT......T@@@@@@@@@@@@@@@@@@@@@@@@@@@@
@@@@@@@@@@@@@@@@@@@@@@@@@@@@@@@@TT.....................TTT......T@@@@@@@@@@@@@@@@@@@@@@@@@@@@
@@@@@@@@@@@@@@@@@@@@@@@@@@@@@@@@TT.....................TTT......T@@@@@@@@@@@@@@@@@@@@@@@@@@@@
@@@@@@@@@@@@@@@@@@@@@@@@@@@@@@@@TTT....................TTT.TTTT.T@@@@@@@@@@@@@@@@@@@@@@@@@@@@
@@@@@@@@@@@@@@@@@@@@@@@@@@@@@@@@TTTT...................TTT.TTTT.T@@@@@@@@@@@@@@@@@@@@@@@@@@@@
@@@@@@@@@@@@@@@@@@@@@@@@@@@@@@@@TTTT.......TTTT........TTT.TTTTTT@@@@@@@@@@@@@@@@@@@@@@@@@@@@
@@@@@@@@@@@@@@@@@@@@@@@@@@@@@@@@TTT........TTTT........TTT..TTT@T@@@@@@@@@@@@@@@@@@@@@@@@@@@@
@@@@@@@@@@@@@@@@@@@@@@@@@@@@@@@@TT......TTTTTTTTTTTT..TTTTTTTTTTT@@@@@@@@@@@@@@@@@@@@@@@@@@@@
@@@@@@@@@@@@@@@@@@@@@@@@@@@@@@@@TT.TTTT.T@@@@@@@@@@@@@@@@@@@@@@@@@@@@@@@@@@@@@@@@@@@@@@@@@@@@
@@@@@@@@@@@@@@@@@@@@@@@@@@@@@@@@TT.TTTTTT@@@@@@@@@@@@@@@@@@@@@@@@@@@@@@@@@@@@@@@@@@@@@@@@@@@@
@@@@@@@@@@@@@@@@@@@@@@@@@@@@@@@@TT.TTTTTT@@@@@@@@@@@@@@@@@@@@@@@@@@@@@@@@@@@@@@@@@@@@@@@@@@@@
@@@@@@@@@@@@@@@@@@@@@@@@@@@@@@@@TTTTTTTTT@@@@@@@@@@@@@@@@@@@@@@@@@@@@@@@@@@@@@@@@@@@@@@@@@@@@
