type octile
height 5
width 21
map
TTTTTTTTTTTTTTTTTTTTT
T...................T
T.TTTTTTTT.TTTTTTTT.T
T.TTTTTTTT.TTTTTTTT.T
TTTTTTTTTTTTTTTTTTTTT